111111111111111111111111111111111111
130200000000000010000000000000000001
111011111111011110000000000000000001
101010000001010000000000000000000001
100010000001010010000000000000000001
101001000000211010000000000000000001
101101000000000010000000000000000001
101001000000000010000000000000000001
100002000000000010000000000000000001
101001000000000010000000000000000001
101101000000000010000000000000000001
101001000000000010000000000000000001
100010000000000010000000000000000001
121100000000000010000000000000000001
100000000000000010000000000000000001
100000000000000010000000000000000001
100000000000000010000000000000000001
111111111111111111111112111111111111