111111111111111111111111111111111111
130000000200000020000000000000000001
111011110101011111111112111112111121
101001012101010000000000000000000001
100001010101010011121111011111112111
101001010101011210000101010000000001
101101010101000010000101010111111001
101001010201111110100101010100001001
100002010100000020100101010100101001
101001011111111110100101010111101001
101101000000000010100101010000001001
101001111111111010100101011111011001
100001000000001020100200000201010001
121111011111111010111111111101211121
101000000000000010200000000001000001
101111121111111111111111211111004001
100000000002000000000000000002000001
111111111111111111111111111111111111