111111111111111111111111111111111111
130000000100000010000000000000000001
111011112101011110111110111110111101
101001010101010000000000000000000001
100001010101010011121111211111112111
101001010101211010000101010000000001
101101010101000010000101010111111001
101001010201111110100101010100001001
100002010100000010100101010100101001
101001011111111110100101010111101001
101101000000000010100101010000001001
101001111111111010100101011111011001
100001000000001010100100000201010001
121111011111111010111111111101211121
101000000000000010200000000001000001
101111111111111111111111111111004001
100000000000000000200000000002000001
111111111111111111111111111111111111